AAAGGCGATGAAGACACCAT -> AAGGCGATGAAGACACCATC
AACTGATCGAGCGGTTTGAA -> ACTGATCGAGCGGTTTGAAC
AAGACACCATCATGGAAGCA -> AGACACCATCATGGAAGCAG
AAGACGTTGTGACCTATGAT -> AGACGTTGTGACCTATGATG
AAGCAGCACTGGAAGCAGGT -> AGCAGCACTGGAAGCAGGTG
AAGCAGGTGCTGAAGACGTT -> AGCAGGTGCTGAAGACGTTG
AAGGCGATGAAGACACCATC -> AGGCGATGAAGACACCATCA
AATGCCTGACTTACCGCGCT -> ATGCCTGACTTACCGCGCTG
ACACCATCATGGAAGCAGCA -> CACCATCATGGAAGCAGCAC
ACCATCATGGAAGCAGCACT -> CCATCATGGAAGCAGCACTG
ACCGCGCTGTTCCTGCACGT -> CCGCGCTGTTCCTGCACGTA
ACCTATGATGACGGCGCGAT -> CCTATGATGACGGCGCGATT
ACGTAGCGCATCAACTGATC -> CGTAGCGCATCAACTGATCG
ACGTTGTGACCTATGATGAC -> CGTTGTGACCTATGATGACG
ACTGATCGAGCGGTTTGAAC -> CTGATCGAGCGGTTTGAACT
ACTGGAAGCAGGTGCTGAAG -> CTGGAAGCAGGTGCTGAAGA
ACTTACCGCGCTGTTCCTGC -> CTTACCGCGCTGTTCCTGCA
ACTTTCGCGCGGCTGTTGCA -> CTTTCGCGCGGCTGTTGCAG
AGAAAGGCGATGAAGACACC -> GAAAGGCGATGAAGACACCA
AGACACCATCATGGAAGCAG -> GACACCATCATGGAAGCAGC
AGACGTTGTGACCTATGATG -> GACGTTGTGACCTATGATGA
AGATAATGCCTGACTTACCG -> GATAATGCCTGACTTACCGC
AGCACTGGAAGCAGGTGCTG -> GCACTGGAAGCAGGTGCTGA
AGCAGCACTGGAAGCAGGTG -> GCAGCACTGGAAGCAGGTGC
AGCAGGTGCTGAAGACGTTG -> GCAGGTGCTGAAGACGTTGT
AGCGCATCAACTGATCGAGC -> GCGCATCAACTGATCGAGCG
AGGCGATGAAGACACCATCA -> GGCGATGAAGACACCATCAT
AGGTGCTGAAGACGTTGTGA -> GGTGCTGAAGACGTTGTGAC
AGTAGATAATGCCTGACTTA -> GTAGATAATGCCTGACTTAC
ATAATGCCTGACTTACCGCG -> TAATGCCTGACTTACCGCGC
ATCAACTGATCGAGCGGTTT -> TCAACTGATCGAGCGGTTTG
ATCATGGAAGCAGCACTGGA -> TCATGGAAGCAGCACTGGAA
ATCGAGCGGTTTGAACTTCT -> TCGAGCGGTTTGAACTTCTC
ATCTCCTTCGAGAAAGGCGA -> TCTCCTTCGAGAAAGGCGAT
ATGAAGACACCATCATGGAA -> TGAAGACACCATCATGGAAG
ATGATGACGGCGCGATTGAT -> TGATGACGGCGCGATTGATG
ATGCCTGACTTACCGCGCTG -> TGCCTGACTTACCGCGCTGT
ATGGAAGCAGCACTGGAAGC -> TGGAAGCAGCACTGGAAGCA
CAACTGATCGAGCGGTTTGA -> AACTGATCGAGCGGTTTGAA
CACCATCATGGAAGCAGCAC -> ACCATCATGGAAGCAGCACT
CACGTAGCGCATCAACTGAT -> ACGTAGCGCATCAACTGATC
CACTGGAAGCAGGTGCTGAA -> ACTGGAAGCAGGTGCTGAAG
CAGCACTGGAAGCAGGTGCT -> AGCACTGGAAGCAGGTGCTG
CAGGTGCTGAAGACGTTGTG -> AGGTGCTGAAGACGTTGTGA
CAGTAGATAATGCCTGACTT -> AGTAGATAATGCCTGACTTA
CATCAACTGATCGAGCGGTT -> ATCAACTGATCGAGCGGTTT
CATCATGGAAGCAGCACTGG -> ATCATGGAAGCAGCACTGGA
CATGGAAGCAGCACTGGAAG -> ATGGAAGCAGCACTGGAAGC
CCATCATGGAAGCAGCACTG -> CATCATGGAAGCAGCACTGG
CCGCGCTGTTCCTGCACGTA -> CGCGCTGTTCCTGCACGTAG
CCTATGATGACGGCGCGATT -> CTATGATGACGGCGCGATTG
CCTGACTTACCGCGCTGTTC -> CTGACTTACCGCGCTGTTCC
CCTGCACGTAGCGCATCAAC -> CTGCACGTAGCGCATCAACT
CCTTCGAGAAAGGCGATGAA -> CTTCGAGAAAGGCGATGAAG
CGAGAAAGGCGATGAAGACA -> GAGAAAGGCGATGAAGACAC
CGAGCGGTTTGAACTTCTCC -> GAGCGGTTTGAACTTCTCCA
CGATGAAGACACCATCATGG -> GATGAAGACACCATCATGGA
CGCATCAACTGATCGAGCGG -> GCATCAACTGATCGAGCGGT
CGCGCGGCTGTTGCAGTAGA -> GCGCGGCTGTTGCAGTAGAT
CGCGCTGTTCCTGCACGTAG -> GCGCTGTTCCTGCACGTAGC
CGCGGCTGTTGCAGTAGATA -> GCGGCTGTTGCAGTAGATAA
CGCTGTTCCTGCACGTAGCG -> GCTGTTCCTGCACGTAGCGC
CGGCTGTTGCAGTAGATAAT -> GGCTGTTGCAGTAGATAATG
CGTAGCGCATCAACTGATCG -> GTAGCGCATCAACTGATCGA
CGTTGTGACCTATGATGACG -> GTTGTGACCTATGATGACGG
CTACTTTCGCGCGGCTGTTG -> TACTTTCGCGCGGCTGTTGC
CTATGATGACGGCGCGATTG -> TATGATGACGGCGCGATTGA
CTCCTTCGAGAAAGGCGATG -> TCCTTCGAGAAAGGCGATGA
CTGAAGACGTTGTGACCTAT -> TGAAGACGTTGTGACCTATG
CTGACTTACCGCGCTGTTCC -> TGACTTACCGCGCTGTTCCT
CTGATCGAGCGGTTTGAACT -> TGATCGAGCGGTTTGAACTT
CTGCACGTAGCGCATCAACT -> TGCACGTAGCGCATCAACTG
CTGGAAGCAGGTGCTGAAGA -> TGGAAGCAGGTGCTGAAGAC
CTGTTCCTGCACGTAGCGCA -> TGTTCCTGCACGTAGCGCAT
CTGTTGCAGTAGATAATGCC -> TGTTGCAGTAGATAATGCCT
CTTACCGCGCTGTTCCTGCA -> TTACCGCGCTGTTCCTGCAC
CTTCGAGAAAGGCGATGAAG -> TTCGAGAAAGGCGATGAAGA
CTTCTACTTTCGCGCGGCTG -> TTCTACTTTCGCGCGGCTGT
CTTTCGCGCGGCTGTTGCAG -> TTTCGCGCGGCTGTTGCAGT
GAAAGGCGATGAAGACACCA -> AAAGGCGATGAAGACACCAT
GAAGACACCATCATGGAAGC -> AAGACACCATCATGGAAGCA
GAAGACGTTGTGACCTATGA -> AAGACGTTGTGACCTATGAT
GAAGCAGCACTGGAAGCAGG -> AAGCAGCACTGGAAGCAGGT
GAAGCAGGTGCTGAAGACGT -> AAGCAGGTGCTGAAGACGTT
GACACCATCATGGAAGCAGC -> ACACCATCATGGAAGCAGCA
GACCTATGATGACGGCGCGA -> ACCTATGATGACGGCGCGAT
GACGTTGTGACCTATGATGA -> ACGTTGTGACCTATGATGAC
GACTTACCGCGCTGTTCCTG -> ACTTACCGCGCTGTTCCTGC
GAGAAAGGCGATGAAGACAC -> AGAAAGGCGATGAAGACACC
GAGCGGTTTGAACTTCTCCA -> AGCGGTTTGAACTTCTCCAT
GATAATGCCTGACTTACCGC -> ATAATGCCTGACTTACCGCG
GATCGAGCGGTTTGAACTTC -> ATCGAGCGGTTTGAACTTCT
GATCTCCTTCGAGAAAGGCG -> ATCTCCTTCGAGAAAGGCGA
GATGAAGACACCATCATGGA -> ATGAAGACACCATCATGGAA
GCACGTAGCGCATCAACTGA -> CACGTAGCGCATCAACTGAT
GCACTGGAAGCAGGTGCTGA -> CACTGGAAGCAGGTGCTGAA
GCAGCACTGGAAGCAGGTGC -> CAGCACTGGAAGCAGGTGCT
GCAGGTGCTGAAGACGTTGT -> CAGGTGCTGAAGACGTTGTG
GCAGTAGATAATGCCTGACT -> CAGTAGATAATGCCTGACTT
GCATCAACTGATCGAGCGGT -> CATCAACTGATCGAGCGGTT
GCCTGACTTACCGCGCTGTT -> CCTGACTTACCGCGCTGTTC
GCGATGAAGACACCATCATG -> CGATGAAGACACCATCATGG
GCGCATCAACTGATCGAGCG -> CGCATCAACTGATCGAGCGG
GCGCGGCTGTTGCAGTAGAT -> CGCGGCTGTTGCAGTAGATA
GCGCTGTTCCTGCACGTAGC -> CGCTGTTCCTGCACGTAGCG
GCGGCTGTTGCAGTAGATAA -> CGGCTGTTGCAGTAGATAAT
GCTGAAGACGTTGTGACCTA -> CTGAAGACGTTGTGACCTAT
GCTGTTCCTGCACGTAGCGC -> CTGTTCCTGCACGTAGCGCA
GCTGTTGCAGTAGATAATGC -> CTGTTGCAGTAGATAATGCC
GGAAGCAGCACTGGAAGCAG -> GAAGCAGCACTGGAAGCAGG
GGAAGCAGGTGCTGAAGACG -> GAAGCAGGTGCTGAAGACGT
GGCGATGAAGACACCATCAT -> GCGATGAAGACACCATCATG
GGCTGTTGCAGTAGATAATG -> GCTGTTGCAGTAGATAATGC
GGTGCTGAAGACGTTGTGAC -> GTGCTGAAGACGTTGTGACC
GTAGATAATGCCTGACTTAC -> TAGATAATGCCTGACTTACC
GTAGCGCATCAACTGATCGA -> TAGCGCATCAACTGATCGAG
GTGACCTATGATGACGGCGC -> TGACCTATGATGACGGCGCG
GTGATCTCCTTCGAGAAAGG -> TGATCTCCTTCGAGAAAGGC
GTGCTGAAGACGTTGTGACC -> TGCTGAAGACGTTGTGACCT
GTTCCTGCACGTAGCGCATC -> TTCCTGCACGTAGCGCATCA
GTTGCAGTAGATAATGCCTG -> TTGCAGTAGATAATGCCTGA
GTTGTGACCTATGATGACGG -> TTGTGACCTATGATGACGGC
TAATGCCTGACTTACCGCGC -> AATGCCTGACTTACCGCGCT
TACCGCGCTGTTCCTGCACG -> ACCGCGCTGTTCCTGCACGT
TACTTTCGCGCGGCTGTTGC -> ACTTTCGCGCGGCTGTTGCA
TAGATAATGCCTGACTTACC -> AGATAATGCCTGACTTACCG
TAGCGCATCAACTGATCGAG -> AGCGCATCAACTGATCGAGC
TATGATGACGGCGCGATTGA -> ATGATGACGGCGCGATTGAT
TCAACTGATCGAGCGGTTTG -> CAACTGATCGAGCGGTTTGA
TCATGGAAGCAGCACTGGAA -> CATGGAAGCAGCACTGGAAG
TCCTGCACGTAGCGCATCAA -> CCTGCACGTAGCGCATCAAC
TCCTTCGAGAAAGGCGATGA -> CCTTCGAGAAAGGCGATGAA
TCGAGAAAGGCGATGAAGAC -> CGAGAAAGGCGATGAAGACA
TCGAGCGGTTTGAACTTCTC -> CGAGCGGTTTGAACTTCTCC
TCGCGCGGCTGTTGCAGTAG -> CGCGCGGCTGTTGCAGTAGA
TCTACTTTCGCGCGGCTGTT -> CTACTTTCGCGCGGCTGTTG
TCTCCTTCGAGAAAGGCGAT -> CTCCTTCGAGAAAGGCGATG
TGAAGACACCATCATGGAAG -> GAAGACACCATCATGGAAGC
TGAAGACGTTGTGACCTATG -> GAAGACGTTGTGACCTATGA
TGACCTATGATGACGGCGCG -> GACCTATGATGACGGCGCGA
TGACTTACCGCGCTGTTCCT -> GACTTACCGCGCTGTTCCTG
TGATCGAGCGGTTTGAACTT -> GATCGAGCGGTTTGAACTTC
TGATCTCCTTCGAGAAAGGC -> GATCTCCTTCGAGAAAGGCG
TGCACGTAGCGCATCAACTG -> GCACGTAGCGCATCAACTGA
TGCAGTAGATAATGCCTGAC -> GCAGTAGATAATGCCTGACT
TGCCTGACTTACCGCGCTGT -> GCCTGACTTACCGCGCTGTT
TGCTGAAGACGTTGTGACCT -> GCTGAAGACGTTGTGACCTA
TGGAAGCAGCACTGGAAGCA -> GGAAGCAGCACTGGAAGCAG
TGGAAGCAGGTGCTGAAGAC -> GGAAGCAGGTGCTGAAGACG
TGTGACCTATGATGACGGCG -> GTGACCTATGATGACGGCGC
TGTTCCTGCACGTAGCGCAT -> GTTCCTGCACGTAGCGCATC
TGTTGCAGTAGATAATGCCT -> GTTGCAGTAGATAATGCCTG
TTACCGCGCTGTTCCTGCAC -> TACCGCGCTGTTCCTGCACG
TTCCTGCACGTAGCGCATCA -> TCCTGCACGTAGCGCATCAA
TTCGAGAAAGGCGATGAAGA -> TCGAGAAAGGCGATGAAGAC
TTCGCGCGGCTGTTGCAGTA -> TCGCGCGGCTGTTGCAGTAG
TTCTACTTTCGCGCGGCTGT -> TCTACTTTCGCGCGGCTGTT
TTGCAGTAGATAATGCCTGA -> TGCAGTAGATAATGCCTGAC
TTGTGACCTATGATGACGGC -> TGTGACCTATGATGACGGCG
TTTCGCGCGGCTGTTGCAGT -> TTCGCGCGGCTGTTGCAGTA
